#################################
#                               #
#                               #
#                               #
#                               #
#        ###         ###        #
#        ###         ###        #
#        #                      #
#        #                      #
#        #                      #
#        #                      #
#        #                      #
#        #                      #
#        #                      #
#        #                      #
#        #                      #
#################################
                                 
